codon	amino_acid	possible_start
TTT	F	no
TTC	F	no
TTA	L	no
TTG	L	no
TCT	S	no
TCC	S	no
TCA	S	no
TCG	S	no
TAT	Y	no
TAC	Y	no
TAA	E/*	no
TAG	E/*	no
TGT	C	no
TGC	C	no
TGA	W	no
TGG	W	no
CTT	L	no
CTC	L	no
CTA	L	no
CTG	L	no
CCT	P	no
CCC	P	no
CCA	P	no
CCG	P	no
CAT	H	no
CAC	H	no
CAA	Q	no
CAG	Q	no
CGT	R	no
CGC	R	no
CGA	R	no
CGG	R	no
ATT	I	no
ATC	I	no
ATA	I	no
ATG	M	yes
ACT	T	no
ACC	T	no
ACA	T	no
ACG	T	no
AAT	N	no
AAC	N	no
AAA	K	no
AAG	K	no
AGT	S	no
AGC	S	no
AGA	R	no
AGG	R	no
GTT	V	no
GTC	V	no
GTA	V	no
GTG	V	no
GCT	A	no
GCC	A	no
GCA	A	no
GCG	A	no
GAT	D	no
GAC	D	no
GAA	E	no
GAG	E	no
GGT	G	no
GGC	G	no
GGA	G	no
GGG	G	no
